                  j            e       e      s    s   s






                            #   #
   
                      #               #
                               #      
#   #            #           
 
             #
 
   #      #                            

#   #   #   #   #   #   #   #   #   #   #   #   #   #   #   #   #   #   #   #   #   #   #   #